OLGA       : ROSARIO    NANCY     
ROB        : MERLE      SOLOMON    KRISTINE  
DORIS      : SWEET      NORMA      CASEY     
WILLARD    : SOTO       BOWERS     DENA       DELACRUZ   WALLER    
COLON      : HOLLAND   
MAVIS      : ROSEANN    ASHLEE     GILLESPIE  HALL       MCBRIDE   
LANDON     : COLLIER   
KATHERINE  : MILES      MARGERY    TRAVIS    
PAGE       : WEBER      ART        HOGAN      RUSSEL    
HOOPER     : MERCADO    SPENCE     ELOISE    
OLIVER     : LORIE      JUAREZ    
CASTILLO   : MARSH      TEDDY     
TRENTON    : GILL       THOMPSON   AURORA     MEADOWS    FREDERICK 
RAMSEY     : SANTIAGO   FLETCHER   JAIME      WILFREDO   CAIN       SHELLEY   
VILMA      : JENNINGS   MONTGOMERY PICKETT    RICHARD    MACIAS    
MCDONALD   : RICKY      BONNER     BEASLEY   
PEARSON    : DERICK     GOODWIN    ESTRADA   
WALTON     : DONA       KATHLEEN   HICKS      EVAN      
CARLSON    : ANIBAL     WEISS      CLAUDIA   
MARISOL    : BOYER     
LESTER     : AMIE       VONDA      BUTLER     MARISSA    MCCLURE   
MANN       : TODD       ZAMORA     RAPHAEL    RACHAEL   
PERRY      : BLACKWELL  GIOVANNI   MORRIS     BRYANT    
KATY       : IGNACIO    DENNIS     CALLAHAN  
MARK       : LEANNE     TYREE      WENDY      SIMPSON   
ANTONE     : CAROLYN    DELANEY    JOHNSTON  
JOHN       : LILA       LUISA      ALBERTO   
MAXWELL    : DIONNE     GILBERT    HENRY     
ANNA       : DUNN       HOLMAN     FLETCHER   CONTRERAS  COLLINS    LLOYD     
LETITIA    : JACKIE     CORY       LYMAN      ED         IAN       
VALERIE    : TAYLOR     LATISHA    TOMMY      INGRAM    
MCKAY      : RODGERS    GOLDIE     PAT        KENDRA    
PRINCE     : CANDICE    ESTEBAN   
LUCIEN     : MCCONNELL  MARGARITO 
CHANEY     : CECELIA    BRIDGET   
GILMORE    : REEVES     DENIS      GENEVA    
LESLIE     : EDWIN      DUFFY     
MARION     : PITTS      BRIANA     SERRANO   
GLENN      : MURIEL     NIKKI     
LEE        : FRY        BUTLER     ALEXANDRA  LORNA     
HATFIELD   : ELISEO     VICTORIA  
CRYSTAL    : DUSTY      SHEPHERD   ELBERT    
LUCILLE    : TOBY       DUSTY      EMILY      IRVIN      AIDA      
PATE       : BENJAMIN   CORY      
MONICA     : DEWAYNE    HORN       HUGH       JANETTE    GLOVER     EVE       
LENARD     : GARTH      HEBERT     ISIDRO     JAY        HAYDEN    
RAMIRO     : EVE       
PHOEBE     : LANA       WELCH      DELGADO   
FOX        : CALDWELL   ROTH      
ROBERTA    : LAMBERT    DEANA     
BENJAMIN   : PATE       WOODARD    CLARENCE   JACKSON   
LEONOR     : PENNINGTON QUINCY     SALINAS    PHILLIP   
TILLMAN    : ROBBY      TASHA      JOYNER    
AVIS       : JEFFERSON  SHEPHERD   HARRIS     HUNT      
ANDERSON   : STUART     KOCH       JOAN       MORENO    
JENNINGS   : VILMA      JIMENEZ    DURAN      REINALDO  
LATONYA    : BYRD       ROSALINDA  BATTLE    
ODESSA     : DAWN       KELLEY    
LILIANA    : WARNER     LINDSAY   
LITTLE     : LAMBERT    SWANSON    MOHAMED   
MADELINE   : SIMON      BYRD       LES        OLSON     
PERCY      : SYBIL      CAIN      
WARD       : CHELSEA    STOUT      KENDALL    BARTON    
KNOX       : FISCHER    CLEMONS    JOHNSON   
FIELDS     : CHELSEA    ROBLES     RICK      
AMIE       : LESTER     MAGGIE     SYKES     
WITT       : AYALA      HOLLOWAY  
CANDICE    : PRINCE     FARLEY     WOODARD    COMPTON    BARR      
MONTGOMERY : VILMA      JOHNSTON  
JANELLE    : HERRERA    LEANNE     HELGA     
HOLDEN     : GONZALO    BRANDI    
DERICK     : PEARSON    HARVEY     NEAL      
MEREDITH   : DEWAYNE    DIXIE      TRUDY     
WALTERS    : DINO       GREGORY    MILLIE    
ABE        : ARIEL      ERMA      
JACKIE     : LETITIA    JESSIE     MAYS      
COPELAND   : DAWN      
ESTES      : ALFONZO    HUMBERTO   ROSALES   
HERRERA    : JANELLE    NANETTE    VALENZUELA
THELMA     : MARGARITA  RUSSEL     MARTIN    
MILAGROS   : VONDA      MOLINA     WEAVER    
ARIEL      : ABE        MOSES      WHITAKER   TINA       SELLERS   
MERCADO    : HOOPER     MARTHA     BROWN      KEITH      TORRES     LACEY     
MCNEIL     : CAMERON    DONALD     TANIA      LEON      
SIMON      : MADELINE   ALBA       MCCULLOUGH KARLA     
TODD       : MANN       TABATHA    TATE      
MARCELINO  : MOSS      
WILCOX     : HERBERT    HOLT       REINALDO  
LEACH      : MERRITT   
IRIS       : FREDDIE    HARMON     HOWELL     FRANKLIN  
INES       : GINGER     WOODARD   
WEBSTER    : HANNAH     BRIAN      RICO      
RAMOS      : FLORENCE   JERALD     JACOB      TONI       KERRI     
BLACKWELL  : PERRY      LANGLEY    TAMMIE    
ANIBAL     : CARLSON    GRIFFIN    JOANNA     TRUDY     
DONOVAN    : AUSTIN     ALINE     
LILA       : JOHN       WHITE     
HOBBS      : GUZMAN    
STACIE     : ROSS       GOODMAN    DEANNE     CORRINE   
CHRISTI    : DEANA      HOMER      PAYNE      ROBERTSON 
LOIS       : CORY       OTIS       BULLOCK   
JAMAAL     : SEARS      TAMMY     
BALDWIN    : CAROLYN    HOLT      
MONTY      : MARY       PORTER     JEAN       FERDINAND 
HARRINGTON : EARL       JEAN       TRAVIS    
PICKETT    : VILMA     
EUGENIA    : CINDY     
SAM        : MCFADDEN   BENITO    
OCTAVIO    : REBEKAH    SCHULTZ    RICHARDS   CHANCE     KELLY     
HAMILTON   : DEANDRE   
CRISTINA   : MARA       GENARO    
BRENDAN    : JOHANNA    SHEPARD    BURRIS     THADDEUS  
BARRY      : CARSON     HICKS     
WARREN     : JARVIS     CANTRELL   TRACY     
HANNAH     : WEBSTER    GEORGE     MACIAS    
ERIN       : KEITH      WINFRED   
HOUSTON    : NIGEL      COLLEEN    NORA      
BELL       : ESMERALDA  NIKKI      FAULKNER  
SWEET      : DORIS      DUKE       CROSBY    
BARLOW     : HART       AMANDA     TERRY     
DUNN       : ANNA       LOTTIE    
LANA       : PHOEBE     REYES      CLARK     
YANG       : PAULETTE   MUELLER   
ANDY       : BURGESS    LORRAINE   ROYCE     
HIRAM      : CONRAD     CARROLL    CROSBY    
CONNIE     : ALTA       KARYN     
BARNES     : EDMUND     MARTINEZ   SANDOVAL  
JEFFERSON  : AVIS       MAC        MORRIS     HAROLD    
PAMELA     : FRANKS     GOLDIE     NEIL       ODONNELL  
MERCEDES   : FROST      DELORIS    FAITH      WASHINGTON ESTRADA   
HORTON     : HUBER      MUELLER   
HERBERT    : WILCOX     WYATT      TASHA      BORIS      PATSY     
BARRERA    : WOLFE      TRENT     
MCCONNELL  : LUCIEN     LYMAN      WISE       KEITH     
ROSALIE    : CAROLYN    DOROTHEA  
CHARLOTTE  : CAMERON    KENTON     SANTANA   
JILL       : WEISS      VONDA     
MAC        : JEFFERSON  CRAFT      PAM        PRUITT    
WALDO      : ROJAS     
LEVI       : MILLIE     DUFFY      RACHAEL   
WARNER     : LILIANA    NAPOLEON   TONI      
HARRELL    : MILLICENT  TERRY      PUCKETT   
GOMEZ      : PENNINGTON
SOTO       : WILLARD    TARA       CAMACHO    GRACE      DUFFY     
ABRAHAM    : CATHERINE  JASPER     GONZALES  
JIMENEZ    : JENNINGS   BOWERS     WILBUR     JEREMY    
ALLISON    : SANCHEZ    POLLARD   
BUCKNER    : CHANG      DUSTY      PARKS      STANLEY   
FREDERIC   : DENIS      MURIEL     ROOSEVELT 
COMBS      : MARIBEL    ETTA       MARGERY   
DODSON     : WILL       HARRISON  
REBEKAH    : OCTAVIO    SANTANA   
ROSETTA    : ALTA       WEEKS      FREDRIC    JANETTE    JEREMY     QUINN      CONSUELO  
HARDY      : THOMAS     BARTLETT   FIGUEROA   HELENA    
VELASQUEZ  : TUCKER     FLORES     LORENZO    JIM       
WEBER      : PAGE       KEITH      WATTS     
BAIRD      : DALE       LORI      
ALEXANDER  : WILBUR     ERMA      
BRYON      : ROCCO      MUELLER    BENTON     OTTO      
MARGARITA  : THELMA     DEJESUS    ROSS       WELLS      EARNEST    PARKS     
OCONNOR    : FERN      
ALVIN      : MAGGIE     DELANEY   
FOREST     : RYAN      
CHARITY    : MAGGIE     NADINE    
COOKE      : BOWERS     VICKI     
DIONNE     : MAXWELL    GUTHRIE    ALEXANDRA  CHARMAINE  PARSONS   
TRICIA     : FOSTER     CLINT     
VERA       : DONA       JANICE     BUCKLEY    KANE      
NUNEZ      : BUDDY      ALICIA     SANTANA    MORENO    
ALBA       : SIMON      CLARA     
ISSAC      : KIP        AHMED      ADKINS     KRISTINE  
FLOSSIE    : DONALD    
ELMA       : SAUNDERS   HARMON     BARTON    
BLEVINS    : HUNTER     TEDDY      STEVENSON 
BUCK       : TATE       BIRD      
NICOLE     : MURIEL     CARDENAS  
MCMILLAN   : CHRISTA    ORR        ISIAH      HAZEL     
REEVES     : GILMORE    REYES      MEDINA     LUCIANO    BLAKE      FRANCISCO 
BYRD       : LATONYA    MADELINE   LORI       REYNA     
MOSES      : ARIEL      PHILLIP    MERRILL    TY        
IRWIN      : WELLS     
CAITLIN    : MCCARTY   
STEPHENS   : NOE        ALFRED     ISIDRO    
SYDNEY     : CAROL      LYNN      
DINO       : WALTERS    BRANDY     CONRAD     FULTON    
CLEMENTS   : DEENA      PITTS     
MCCARTHY   : SIMS       NOEMI     
OSCAR      : HILARIO    BARBER     AUBREY     JOSUE     
GRIFFIN    : ANIBAL    
LUNA       : JODIE      MUNOZ      ROWE      
MCKEE      : BURTON    
IVANA      : DEWAYNE    THOMPSON  
BAKER      : SEARS      DIANE      ALVAREZ    ALBERT    
DEENA      : CLEMENTS   ED         ELDON     
WINTERS    : BRANDY    
EMORY      : NORA       EDWIN      ANGELITA  
ROBBIE     : SUSAN      PRESTON   
WEISS      : CARLSON    JILL       JACKSON   
LAUREN     : STACI      MORROW    
ODELL      : NEWMAN     PACHECO    LEONARD   
KNOWLES    : DAWN      
ROBBY      : TILLMAN    AVA       
STUART     : ANDERSON   ROBBINS    HEWITT    
OLA        : CARMELO    ADELINE    PRESTON    TRACY     
GARTH      : LENARD     PAULETTE   JESSE      LIDIA     
BEAN       : GONZALO    GEORGIA    CASEY      BRIGGS    
ANITA      : FRANKS     WILLIE     REGGIE     LENORA     HEAD      
VELMA      : ANA        LE         GLOVER    
KRISTIE    : MALLORY    JOSE      
ARRON      : AURORA    
JOHANNA    : BRENDAN    MARIA      RICHMOND   ASHLEE    
BETTE      : MCLAUGHLIN RASMUSSEN  RUSS       TOWNSEND   MCCARTY   
ROBINSON   : CASANDRA   HINTON     AL         STEVEN     PATRICK   
TABATHA    : TODD       VICTOR    
GRIMES     : SUAREZ     CHRISTINE  MACIAS    
DARNELL    : TUCKER     BRANDY     MORROW     SCHWARTZ  
GILBERT    : MAXWELL    ESMERALDA  RUSSO      BRYAN     
PITTS      : MARION     CLEMENTS   CHANCE    
SANTIAGO   : RAMSEY     ERICK      SLOAN      GLADYS     ADELINE    NIELSEN   
CLAYTON    : REYNOLDS  
GARRETT    : BENTLEY   
MARIA      : JOHANNA    SARGENT    WALLER    
FISCHER    : KNOX       DALE      
CARNEY     : PETTY      JANINE    
DILLON     : COOLEY     MANUEL     LUPE      
CASE       : WHITLEY    TINA       GENARO    
PITTMAN    : BARBER     SUSIE      DON       
SCHNEIDER  : TUCKER     DAPHNE     BURTON    
WYATT      : HERBERT    GRETA     
MCLEOD     : WIGGINS    CAMACHO    WHITE      BARNETT   
MCLAUGHLIN : BETTE      POTTS      GOOD      
WELCH      : PHOEBE     SILVA      SLOAN      REUBEN    
MCKENZIE   : TANIA     
HART       : BARLOW     BRIGITTE  
SPENCE     : HOOPER     NETTIE     WALLS      JOSH      
PENNINGTON : LEONOR     GOMEZ      WONG      
JOHNS      : ORTIZ      REGINA    
HANSON     : NANNIE     NEWTON     ALBERTO   
NOLAN      : MARGUERITE GARZA      JEREMY     WHITE     
DEJESUS    : MARGARITA  PHILLIPS   KENT       ORR        SIMS       FOSTER     SHANNON   
BURT       : MASSEY    
HUNTER     : BLEVINS    JULIA     
MICAH      : MCCULLOUGH MUELLER    CHRISTIAN  CORTEZ    
FANNIE     : EFREN     
CORY       : LETITIA    PATE       LOIS       DAPHNE     CHRISTIAN 
REYES      : LANA       REEVES     HENDRICKS 
URSULA     : HUGHES    
JARVIS     : WARREN     CARLO      WENDY      THADDEUS   FORREST   
JUSTINE    : JOANNA     HODGE     
MARIBEL    : COMBS      ANDREA     ESTEBAN   
RODNEY     : BURGESS    MILLICENT 
HEBERT     : LENARD     MCINTYRE  
SILVA      : WELCH      CALLAHAN   DUNLAP     CASSIE    
JACLYN     : GILES      COTE      
PHILLIPS   : DEJESUS    DEWITT    
TOBY       : LUCILLE    KOCH       DUKE       CAIN      
GONZALEZ   : TERRI     
ELLIS      : ERICKA     HARRISON  
CHARLIE    : KEITH      SANCHEZ    GALLOWAY  
HOLMAN     : ANNA       ELOISE     CARVER    
EDMUND     : BARNES     SIMPSON    JOHNNIE    FUENTES   
FRY        : LEE        EDGARDO    DELACRUZ   NATASHA   
CARSON     : BARRY      YOUNG      LAUREL     WHITNEY   
HUGHES     : URSULA     SLOAN      DWIGHT     JOHNSON   
BURGESS    : ANDY       RODNEY     JOY        MICHEAL    RAUL      
AUSTIN     : DONOVAN    TOWNSEND   MANNING   
PIERCE     : EARLE      CARVER    
DENIS      : GILMORE    FREDERIC   RONNY     
CHANG      : BUCKNER    MICHAEL    MCBRIDE   
HINES      : BRIAN      BERNARDO  
TRACEY     : BROCK     
DARYL      : MCCLURE   
DIAZ       : JOSEPH     RORY      
CECELIA    : CHANEY     ELDON      BERNARDO   RUSSO     
LARSEN     : HUBER      GILES     
RICE       : FINLEY    
BRIAN      : WEBSTER    HINES      MAXINE    
JOHNATHAN  : KURT       THADDEUS   KRISTINE   DEWITT    
BENNIE     : WILBUR    
ERICK      : SANTIAGO   BRIDGETTE  OBRIEN    
LEANNE     : MARK       JANELLE    ANNIE      MCFADDEN  
KENT       : DEJESUS   
COOLEY     : DILLON     CROSS     
TASHA      : TILLMAN    HERBERT    FLOYD      DALTON    
BERT       : HOLT       DIXIE      ALI        JEANNE    
GUY        : PARRISH    YVETTE     HARRISON   FERDINAND 
CLARK      : LANA       GILBERTO  
TUCKER     : VELASQUEZ  DARNELL    SCHNEIDER  ELOISE     MILLER     SCOTT      PORTER     NAVARRO   
VONDA      : LESTER     MILAGROS   JILL       KURT      
FROST      : MERCEDES   MCCORMICK  MARCELO   
NORTON     : KENNEDY    PACHECO    GENARO     GALLOWAY  
CRAFT      : MAC       
LYDIA      : LANE       BARR       POOLE      MACIAS    
FRYE       : TAYLOR     TRAN       MCCARTY   
SELENA     : MCINTYRE  
BRIDGETTE  : ERICK      BENTLEY    ARTHUR     DUNCAN    
WOLF       : CEDRIC     CONSTANCE  MONA      
THOMAS     : HARDY      MARY       CHAN       DEVON     
YOUNG      : CARSON     BOBBIE     LINDSEY   
DEANDRE    : HAMILTON   NELDA      ETHEL     
KIM        : STEVEN    
ENGLAND    : FRANKS     BRYAN     
CHELSEA    : WARD       FIELDS     GEORGE     VARGAS    
AGNES      : CONLEY     CARROLL    ROTH      
SILAS      : CLEVELAND  LEANN      AUTUMN     STEVENSON  HOLLOWAY   SALVATORE 
MAGGIE     : AMIE       ALVIN      CHARITY    JOHNSTON  
HIGGINS    : TARA       NIKKI      JUANITA    DYLAN      HUNT       BAUER     
TYREE      : MARK       LAWSON    
ELOISE     : HOOPER     HOLMAN     TUCKER     ALICIA    
TOM        : INGRID     JARED      AYALA     
MARGUERITE : NOLAN     
DEWAYNE    : MONICA     MEREDITH   IVANA      CRANE      AVA        HERRING    JOYNER     DEAN      
DEWAYNE    : BOWEN     
FLOYD      : TASHA      JIMMIE     VARGAS     DEVON      GALLOWAY  
RICHARD    : VILMA      TRENT     
EDITH      : JEREMY    
WHITAKER   : ARIEL      LEONARDO  
ANNIE      : LEANNE     BEACH      SAMUEL    
FLETCHER   : RAMSEY     ANNA       BLAIR      CARLA     
CHRISTA    : MCMILLAN  
LEONARDO   : WHITAKER   KENTON     WENDI     
LANGLEY    : BLACKWELL  BRUCE      SCOTTIE    ALEXANDRA  DARIN      DELBERT   
STEFANIE   : CONRAD     CLAUDIA   
STEELE     : REUBEN     EVAN      
BARTLETT   : HARDY      NOEMI     
KLINE      : FARLEY     LETICIA    REYNA      ELBERT     ELLIOTT   
KRISTOPHER : CAMERON    FREEMAN    ROOSEVELT  CURRY     
ETTA       : COMBS      STEVEN     FLEMING    HERMAN    
ISABELLE   : ROSEMARY   ERNIE     
AMELIA     : BREWER    
TARA       : SOTO       HIGGINS    GALEN      DEANNE    
ALTON      : ROCCO      TRAN       BAUER     
BALLARD    : NICOLAS    COLEMAN   
ROMERO     : ESMERALDA  CURRY     
RIVERA     : SARA       SAMUEL     DAVENPORT 
JOY        : BURGESS    ROSA       SHERRI    
ALTA       : CONNIE     ROSETTA    RUTLEDGE  
MARIE      : FLORES     RONALD     VALENCIA  
MCCULLOUGH : SIMON      MICAH      RYAN       CONSTANCE  COLLINS   
SEARS      : JAMAAL     BAKER      ROWE      
NEWMAN     : ODELL      SIMONE    
JODIE      : LUNA       JULIE     
JAIME      : RAMSEY     TIMOTHY    SERRANO    DEAN      
BROCK      : TRACEY     BARBER     AMADO     
SLOAN      : SANTIAGO   WELCH      HUGHES     FERN      
NICOLAS    : BALLARD    GONZALO    MABEL     
HENSON     : HOLLAND   
CLAUDETTE  : VERN      
MILLICENT  : HARRELL    RODNEY     DARRELL    MAYS       TYLER     
RIOS       : BRIANA     CONTRERAS  TATE      
XAVIER     : HENRIETTA  WILLIAMS   CANTU      BERNADINE 
CONLEY     : AGNES      HENDRIX    INGRID     ANDREW    
ROSE       : BRADLY     THURMAN    MOODY      MATTHEWS  
MARYANNE   : SHERYL     ELISEO     SWANSON   
DAVIS      : WIGGINS    LAUREL    
POTTS      : MCLAUGHLIN RUSSELL    ERNA       OWEN      
MEDINA     : REEVES     COTTON    
WIGGINS    : MCLEOD     DAVIS      HARRIS     CLEMONS   
BRANDY     : DINO       WINTERS    DARNELL    KATHY      KERI       TRUDY     
BERTIE     : CARDENAS   BILLIE    
BRIGHT     : DONA       LARSON     DAREN      ROWE       KELLY     
FRANKS     : PAMELA     ANITA      ENGLAND    ELVIRA     KARLA     
FORBES     : SHEPARD   
MARY       : MONTY      THOMAS     PAULETTE   MARGERY    TEDDY      FERDINAND 
CARLENE    : WHITFIELD  ADDIE     
HARVEY     : DERICK     ERNIE     
MILLER     : TUCKER     TABITHA   
DARRELL    : MILLICENT  COFFEY     FUENTES   
FEDERICO   : NEIL       PAT        DURAN      LEON       RANDOLPH  
LEWIS      : GINGER    
CECIL      : WHITLEY    HINTON    
RICO       : WEBSTER    GARRY      BEST       JESSE      ROBERTSON 
LUCIANO    : REEVES     MELBA      FAULKNER  
FRIEDA     : KYLE       TONI      
PETTY      : CARNEY     NIGEL      WILKERSON 
TAYLOR     : VALERIE    FRYE       FOWLER    
ERIKA      : PASQUALE  
WILFREDO   : RAMSEY    
STRICKLAND : ART        BURKS     
CASANDRA   : ROBINSON   FOSTER    
FREDDIE    : IRIS       MENDOZA    MATHIS    
ISRAEL     : HERSCHEL   DANIAL    
AMANDA     : BARLOW     CRANE      SERRANO    CARDENAS   COTTON     MONROE    
MOLLIE     : MAE        BERNADETTE ALINE     
GILL       : TRENTON    ANA        PETERSEN  
BONITA     : AURORA     FORREST    WINFRED    FUENTES    KERR      
GARRY      : RICO      
JORDAN     : WILLIS     LUCAS      ANA        CHARMAINE 
KATHY      : BRANDY    
DAPHNE     : SCHNEIDER  CORY       STEVENSON 
WALSH      : LUPE       KAUFMAN    BARNETT   
ANDREA     : MARIBEL    STEVENS    DALTON    
TAMERA     : MCCORMICK 
NOE        : STEPHENS   FAITH      ETHEL     
GIOVANNI   : PERRY      ROSALES    GIBBS     
WILL       : DODSON     ALFREDA    ISIDRO     MARCEL    
JOYCE      : DEANNE    
WHITLEY    : CASE       CECIL      TREVINO   
WEEKS      : ROSETTA   
HILARIO    : OSCAR      ALINE      STEPHENSON
CHAN       : THOMAS     EMILY      SYKES      CHRISTIAN  STACY      NICHOLSON 
BEST       : RICO      
FLORES     : VELASQUEZ  MARIE     
JOANNA     : ANIBAL     JUSTINE    CROSS      FERRELL   
DONNY      : MAYS       MERLE     
BRADLY     : ROSE       MILDRED   
BUTLER     : LESTER     LEE       
VASQUEZ    : SUSIE      GALLAGHER 
NICHOLS    : AYERS      EVERETT    BARKER     ALFONSO   
KERRY      : KIDD       HURST      ALFRED    
BORIS      : HERBERT    KENDALL    ADAMS      ERNA      
VICKY      : FRANCES   
COOK       : SUSAN      CANDY      REYNOLDS  
ROY        : DANIELS    PAT        RICK       BRADFORD   HARRIET   
BOWERS     : WILLARD    JIMENEZ    COOKE      HEATH      ROBLES     HELGA      LAWANDA   
HEATH      : BOWERS     WEAVER     EVANGELINA
STOUT      : WARD       MARGARITO  STEWART   
CLYDE      : HICKS      STEVENS    BASIL     
DANIELLE   : THADDEUS  
PHILIP     : MARGERY   
HANEY      : LEMUEL    
RUTLEDGE   : ALTA       OTIS      
DONA       : WALTON     VERA       BRIGHT     HURST     
LOURDES    : LINDSAY    ROBBINS    CURRY     
MCFADDEN   : SAM        LEANNE     PATEL      NANETTE    EVE       
TIMOTHY    : JAIME      FRANCIS    WILLIAMS   OTTO      
DIANE      : BAKER      JOYNER     CROSBY    
NEAL       : DERICK     JACKSON    AIDA      
KATHARINE  : JAYNE      CHARMAINE 
KRISTINA   : PAULETTE  
BOBBIE     : YOUNG      OLSEN     
MANUEL     : DILLON     TREY      
ANNMARIE   : NETTIE     JOSE      
SCOTT      : TUCKER     HILL       PETERSEN  
PECK       : SANFORD   
CANTRELL   : WARREN    
JULIO      : LORIE     
ABEL       : ORR        LORI       TAMMY     
ROCCO      : BRYON      ALTON      RORY      
FIGUEROA   : HARDY     
JULIA      : HUNTER     CARROLL    EARNEST    OLSON     
HENSLEY    : HOPKINS    VALENTINE  GENARO    
ROXANNE    : DAWN       GLASS      CRAIG      MARTIN    
BURTON     : MCKEE      SCHNEIDER  DELGADO    RAUL      
GLADYS     : SANTIAGO   MADDEN    
SIDNEY     : KRISTEN    RICK      
WOODWARD   : JESSIE     ALFONZO    AISHA     
LAMBERT    : ROBERTA    LITTLE     TERRI     
DEANA      : ROBERTA    CHRISTI    NORRIS    
CAROLYN    : ANTONE     BALDWIN    ROSALIE    SEBASTIAN  ENID       CARLA     
CUNNINGHAM : BOWEN     
SARA       : RIVERA     DOYLE      SOLOMON   
KERI       : BRANDY     WEAVER     ROBIN      JAY       
GONZALO    : HOLDEN     BEAN       NICOLAS    ELVIRA    
DOYLE      : SARA       MARYELLEN  BURRIS    
ADAM       : SHANNON    DEWITT    
IGNACIO    : KATY       JOSEPH     CHARLENE  
GREGORY    : WALTERS    MENDOZA   
WOLFE      : BARRERA    BOYER      REESE     
MILES      : KATHERINE 
HORN       : MONICA     HUMBERTO   GILES      RACHAEL   
MORRIS     : PERRY      JEFFERSON  STEPHENSON
STARK      : ISIAH      CALVIN    
LORENZO    : VELASQUEZ  LORRAINE   HENDERSON 
KENNEDY    : NORTON     BARKER     ALFRED     BASIL     
ROBLES     : FIELDS     BOWERS     WILKINSON 
LEBLANC    : DENA       MAE       
REUBEN     : WELCH      STEELE    
LYMAN      : LETITIA    MCCONNELL 
DALE       : BAIRD      FISCHER    MCCARTY    ESTRADA   
DARCY      : MARCIA    
SERGIO     : MONROE    
DONNA      : LINDSEY   
ENRIQUE    : EVERETT    MILLS      LUCY      
SHERYL     : MARYANNE   RICHARDSON HEAD       STANLEY   
MARTINEZ   : BARNES     SWANSON    BOWEN     
ART        : PAGE       STRICKLAND RONALD     FOSTER     RODERICK  
LOTTIE     : DUNN       INA       
CHERI      : LUCAS      ERICKSON  
COLLIER    : LANDON     RICKY      JIM       
HINTON     : ROBINSON   CECIL     
HUBER      : HORTON     LARSEN     OTIS      
MIKE       : JIMMIE     DAMIAN    
RONALD     : MARIE      ART        RICHMOND   FLYNN      HEWITT    
MCCALL     : KENDALL    RANDALL    ANDREW    
ALFREDA    : WILL       BENITO     NANCY     
KARYN      : CONNIE     JESSIE     WILFORD    HOOD      
THOMPSON   : TRENTON    IVANA     
HURLEY     : MASSEY     GRAHAM    
HULL       : BRUCE      OMAR       JOSEPHINE 
MARCI      : HOLDER     BOWMAN     RANDOLPH  
TAMMI      : TATE       IAN        HERMAN    
ELISEO     : HATFIELD   MARYANNE   MARSH      MERRITT   
CAMACHO    : SOTO       MCLEOD     WILLIAMS   CHARLENE   ROSALES   
LENORE     : CHERRY    
BOYD       : ALFONZO    HOMER     
HEIDI      : SHERMAN    ROBERT    
CARISSA    : ANTONIO    BARNETT   
MALDONADO  : SUSAN      NEIL      
CARMINE    : NORA       BULLOCK    TRACY     
PAULETTE   : YANG       GARTH      MARY       KRISTINA   WILBUR     AHMED      VANCE     
HOPKINS    : HENSLEY    ERIK      
MARYELLEN  : DOYLE      VICTOR    
MOSS       : MARCELINO  BURRIS     ERNIE      SALVATORE  ANGELITA  
CHANDLER   : HERMINIA   BRADSHAW   MILDRED   
GRETA      : WYATT      LINDA      JARED      HOFFMAN    ALISSA    
LORRAINE   : ANDY       LORENZO    NORMA      TORRES     CUMMINGS  
RASMUSSEN  : BETTE      SUZETTE    HUDSON     BRAY       LOGAN     
CROSS      : COOLEY     JOANNA     COLEMAN    GOODWIN   
AYERS      : NICHOLS    PARK       WALL      
BEACH      : ANNIE      ALVAREZ    SIMS       BOB       
ODOM       : KRAMER    
KENDALL    : WARD       BORIS      MCCALL    
PAM        : MAC        DAVENPORT 
VICTORIA   : HATFIELD   RUSSELL    HAWKINS    FINLEY    
DENA       : WILLARD    LEBLANC    HAYDEN    
LANE       : LYDIA      KELLEY    
SUAREZ     : GRIMES     MILO      
MARA       : CRISTINA   FRANKLIN  
CLAY       : TONI       SHELLEY   
HOLLIE     : MONTOYA    WELDON    
CHAVEZ     : NELDA     
LES        : MADELINE   MARSH      WILLIE    
THURMAN    : ROSE       ALINE     
HUGH       : MONICA     DYER       DELMAR     MORROW    
SCHULTZ    : OCTAVIO    TREY      
SAMUEL     : ANNIE      RIVERA     WILLIS     AUBREY    
FRANCESCA  : BUCKLEY    ELINOR    
HOLCOMB    : JOSE      
SHANA      : FERN       EARLE      PHELPS    
BUDDY      : NUNEZ      ADELINE    INA        REGINA    
NIGEL      : HOUSTON    PETTY     
MILLIE     : WALTERS    LEVI       BATTLE    
RICHARDS   : OCTAVIO    ROBIN      SYBIL      SHERMAN   
BERGER     : MILLS      LENORA    
BURCH      : QUINCY    
SOLIS      : MONTOYA    ARNULFO   
FARLEY     : CANDICE    KLINE     
DOMINGO    : KEVEN      PRISCILLA  BARBRA    
DOROTHEA   : ROSALIE    PUCKETT    DEMETRIUS 
ELIZA      : JACOBS     PUGH       FREDERICK 
RODRIGUEZ  : TIMMY     
JOSEPH     : DIAZ       IGNACIO    OTIS       TONIA     
GALEN      : TARA       KIP        JAMEL      BRYAN     
MOLINA     : MILAGROS   MARKS     
RICARDO    : KNIGHT     ANASTASIA 
CARMELO    : OLA       
RODGERS    : MCKAY      HENDRIX    PACHECO    BENTON    
ORR        : MCMILLAN   DEJESUS    ABEL       LACEY     
DAWN       : ODESSA     COPELAND   KNOWLES    ROXANNE    ERICKA    
PETER      : SERRANO    SONNY      ESTRADA   
LULU       : GERARDO    VICTOR     LANCASTER 
TREY       : MANUEL     SCHULTZ    NEWTON    
HENDRIX    : CONLEY     RODGERS    KOCH       FULTON     DENNIS    
SUSAN      : ROBBIE     COOK       MALDONADO  ANDREW     ANGELITA  
LUPE       : DILLON     WALSH      WILKERSON 
JONI       : TIMMY      DAMIAN     JOSH       CASTRO     FRANKLIN  
HERMINIA   : CHANDLER   RONNY     
EVERETT    : NICHOLS    ENRIQUE    CONRAD     ROD       
WEAVER     : MILAGROS   HEATH      KERI       LENORA    
NETTIE     : SPENCE     ANNMARIE   DYER      
WILLIS     : JORDAN     SAMUEL     WISE      
VERN       : CLAUDETTE  LORI       POLLARD   
RITA       : ELIJAH     CASTRO    
EMILE      : PACHECO    PRISCILLA  JAMAR     
FERNANDEZ  : JERALD     SIMONE     MERCER    
ALVAREZ    : BAKER      BEACH      LENORA    
ED         : LETITIA    DEENA     
BOYER      : MARISOL    WOLFE      DUNLAP     CASTRO    
FLORINE    : WATERS    
FOWLER     : TAYLOR     MOODY      JAMAR     
LATISHA    : VALERIE    EARL       RAYMOND    HOLLAND    SHERRI    
LETICIA    : KLINE      MERLE     
CARLO      : JARVIS     FULTON     JOSE      
CONRAD     : HIRAM      DINO       STEFANIE   EVERETT   
ELVIRA     : FRANKS     GONZALO    HOUSE      MACK      
MERLIN     : SAMPSON    VARGAS     ROBERTSON 
KOCH       : ANDERSON   TOBY       HENDRIX    RYAN       JARROD    
PARK       : AYERS      KENDRA    
KEVEN      : DOMINGO    ANTHONY    WILKERSON  CANDY     
ARMSTRONG  : SHAWN      JIM       
KURT       : JOHNATHAN  VONDA      DYLAN      FRANCISCO 
ZAMORA     : MANN       BOBBI      COLEMAN   
SEBASTIAN  : CAROLYN    NOEMI      LAWANDA   
AL         : ROBINSON   MCMAHON   
MARCUS     : AVA       
MICHEAL    : BURGESS    MERLE      INA        LINDSEY   
BLANCHARD  : RAYMOND    LORENA     ERIK       FRANKIE   
TREVINO    : WHITLEY    FRANCIS    DON       
DUSTY      : CRYSTAL    LUCILLE    BUCKNER    BURKS      KASEY     
BRIGITTE   : HART       FREDERICK  VANCE     
ROSS       : STACIE     MARGARITA  LON        JILLIAN   
SONYA      : LEONARD    EARNEST   
LELIA      : MOHAMED    SOSA      
ROSEANN    : MAVIS      VALENTINE  DELANEY   
OTIS       : LOIS       RUTLEDGE   HUBER      JOSEPH     DUKE      
NORRIS     : DEANA      KAUFMAN   
SALAZAR    : LEONARD    ELBERT    
MAE        : MOLLIE     LEBLANC   
WILEY      : STEVENS    KAUFMAN    COMPTON    REGGIE    
LEVINE     : WATTS      MADDEN     DELBERT   
NITA       : MILLS     
CATHERINE  : ABRAHAM    NEWTON     DURAN     
BARKER     : NICHOLS    KENNEDY    AUGUSTINE  MARIANO   
JESSIE     : JACKIE     WOODWARD   KARYN     
PATEL      : MCFADDEN   LINDSAY    KARLA      GRAY      
LORI       : BAIRD      BYRD       ABEL       VERN       ANNABELLE 
TERRI      : GONZALEZ   LAMBERT    LENORA    
MAYS       : JACKIE     MILLICENT  DONNY      BRADFORD   HOOD      
FOREMAN    : MCCRAY     FRANKIE   
ROCKY      : MASSEY     BREWER    
GERARDO    : LULU       KELLEY     TOWNSEND   JAMAR      NICHOLSON 
FRANCES    : VICKY      EDGARDO    BROWN      AUBREY     FERDINAND 
EDGARDO    : FRY        FRANCES    MABEL      SALINAS    DAMON     
PORTER     : MONTY      TUCKER     MARKS      CAIN      
NANETTE    : HERRERA    MCFADDEN   RUSS       SCHROEDER  CORNELIUS 
PACHECO    : ODELL      NORTON     RODGERS    EMILE      LINDA     
KATHLEEN   : WALTON     MERLE     
SHIRLEY    : HENRIETTA 
AURELIA    : ANDREW     STANLEY   
POPE       : CATHRYN    HALL       BAUER     
VICTOR     : TABATHA    MARYELLEN  LULU       TINA      
DANIELS    : ROY        RAYMOND   
MARTHA     : MERCADO    NEIL       CASSIE    
BRIANA     : MARION     RIOS      
REYNA      : BYRD       KLINE      ELBERT    
QUINCY     : LEONOR     BURCH      BENTLEY    SANFORD   
HOLDER     : MARCI      CLEVELAND  OMAR       ROSARIO    STANLEY   
NAPOLEON   : WARNER     HOOD      
GABRIELA   : STRONG    
BETHANY    : KENTON    
SHEPARD    : BRENDAN    FORBES     MARSH     
LAUREL     : CARSON     DAVIS      KRISTEN    FUENTES   
FLORENCE   : RAMOS      INGRID     FRANKLIN  
ROSA       : JOY        GINGER    
HAROLD     : JEFFERSON  PALMER    
SANDOVAL   : BARNES     CHERRY    
HENRIETTA  : XAVIER     SHIRLEY    STANTON    KYLE       ARTHUR     OWEN      
WHITFIELD  : CARLENE    GENARO     BRYAN      SHERRI    
CLARA      : ALBA       ESTRADA   
FULTON     : DINO       HENDRIX    CARLO      MARIANO    TRAVIS     MONA      
ROBIN      : KERI       RICHARDS   VERNON     JULIET     WINFRED   
WALTER     : AVA        ROOSEVELT  HAWKINS   
JANINE     : CARNEY     NIKKI      JESSICA   
BENTLEY    : GARRETT    BRIDGETTE  QUINCY     JOSUE      HENDRICKS 
JASPER     : ABRAHAM    VICKI      BERNARDO  
ERNESTINE  : SHEPHERD   ELVA      
GARZA      : NOLAN      HOOD      
EVANGELINA : HEATH      DELMAR     CONSTANCE 
SHAWN      : ARMSTRONG  CLEVELAND  CARR       ENID      
INGRID     : TOM        CONLEY     FLORENCE   GAY        MARVIN    
LINDA      : GRETA      PACHECO    RICHARDSON
SIMS       : MCCARTHY   DEJESUS    BEACH      SOFIA      ROYCE      NOEL      
MURIEL     : GLENN      FREDERIC   NICOLE     TERRELL    HOGAN      ALINE     
ANNETTE    : BROWN     
LORIE      : OLIVER     JULIO      SAUNDERS   AYALA     
MYRA       : WATERS    
GLASS      : ROXANNE    DEAN      
LINDSAY    : LILIANA    LOURDES    PATEL      NIELSEN    LACEY     
ROBT       : LEONEL     CONTRERAS  RODERICK  
PRUITT     : MAC        ALICIA     MACDONALD 
FOSTER     : TRICIA     DEJESUS    CASANDRA   ART        STANLEY   
VINCENT    : LINDSEY   
NOELLE     : QUINN     
GOODMAN    : STACIE     HOUSE      KASEY     
RYAN       : FOREST     MCCULLOUGH KOCH      
RICHMOND   : JOHANNA    RONALD     OLSEN     
LUCAS      : JORDAN     CHERI      BRADSHAW  
DYER       : HUGH       NETTIE     SONNY     
RUSSELL    : POTTS      VICTORIA   MCCARTY   
BOB        : BEACH      QUINN      BRYAN     
MARIANA    : WENDI      PARSONS   
CRANE      : DEWAYNE    AMANDA     TABITHA   
ADELINE    : OLA        SANTIAGO   BUDDY      SOSA       AIDA      
GINGER     : INES       LEWIS      ROSA      
NANNIE     : HANSON    
MALLORY    : KRISTIE    GIBSON    
REESE      : WOLFE      JARED      ANGIE     
WILBUR     : JIMENEZ    ALEXANDER  BENNIE     PAULETTE   PHILLIP   
CLEVELAND  : SILAS      HOLDER     SHAWN      ROSALINDA  LAWSON    
HOLT       : WILCOX     BALDWIN    BERT       ENGLISH    CASTRO    
LEONEL     : ROBT       SUSIE      DANIEL    
BOOTH      : MORENO    
FERN       : OCONNOR    SLOAN      SHANA      DIXIE     
CALDWELL   : FOX        MERCER    
WILFORD    : KARYN      JOAN       EVANGELINE
HENDERSON  : LORENZO    IRA        GUZMAN     DARRYL    
LANCASTER  : LULU       JARROD     RORY       FERRELL    LEROY      VAUGHN    
MARGARITO  : LUCIEN     STOUT      ANTONIO    WHITNEY   
BOLTON     : HARRISON   TANYA      DANIEL    
BRUCE      : LANGLEY    HULL       MACIAS     WELDON    
DENNIS     : KATY       HENDRIX    MONTOYA   
HAYS       : JACOBS     ANGIE     
SUZETTE    : RASMUSSEN 
BROWN      : MERCADO    FRANCES    ANNETTE   
KELLEY     : ODESSA     LANE       GERARDO   
RODRIQUEZ  : AUGUSTINE  IAN        RICHARDSON
JERALD     : RAMOS      FERNANDEZ  ERNIE     
DELACRUZ   : WILLARD    FRY       
FREDRIC    : ROSETTA    POLLARD   
ANA        : VELMA      GILL       JORDAN     WILKINSON 
JIMMIE     : FLOYD      MIKE      
MYERS      : HEAD      
EARL       : HARRINGTON LATISHA    PETERSEN  
VIRGIE     : DAREN     
STEVEN     : ROBINSON   KIM        ETTA       MABEL     
ANTONIA    : HOMER      COLEMAN   
LIZZIE     : PATSY      PETERSON   ERNA      
CATHRYN    : POPE       WALLS      MCGOWAN   
MARGERY    : KATHERINE  COMBS      MARY       PHILIP     CAMERON   
SNOW       : CORRINE    NGUYEN     QUINTON   
WISE       : MCCONNELL  WILLIS     MACK      
AUGUSTINE  : BARKER     RODRIQUEZ  JOSUE      STEVENSON 
GLORIA     : BRADLEY    QUINN     
CONTRERAS  : ANNA       RIOS       ROBT      
FLEMING    : ETTA       JARRED     TAMMIE    
CAMERON    : MCNEIL     CHARLOTTE  KRISTOPHER MARGERY    RANDALL   
ESMERALDA  : BELL       GILBERT    ROMERO     WENDY      MAYNARD   
HICKS      : WALTON     BARRY      CLYDE     
OMAR       : HULL       HOLDER     TERRENCE   JOYNER     MCMAHON   
GEORGE     : HANNAH     CHELSEA    HARRIET   
AURORA     : TRENTON    ARRON      BONITA    
PRISCILLA  : DOMINGO    EMILE      LARSON     RANDOLPH  
CALLAHAN   : KATY       SILVA      MOISES     TERRENCE   GILBERTO  
ROSEMARY   : ISABELLE   FAITH     
FRANCIS    : TIMOTHY    TREVINO    TIMMY     
TAMMY      : JAMAAL     ABEL       JILLIAN    MCLEAN    
LEANN      : SILAS      GIBBS     
ERICKA     : ELLIS      DAWN       CROSBY    
JANETTE    : MONICA     ROSETTA   
EARLENE    : FREEMAN    SARGENT    JULIAN    
JACOB      : RAMOS      ALI        ELINOR    
CONNER     : ERMA       JEWELL     AUTUMN     JOHNSTON  
DELMAR     : HUGH       EVANGELINA
TATE       : TODD       BUCK       RIOS       TAMMI      KRAMER    
KIP        : ISSAC      GALEN      MITCHELL  
WALLS      : SPENCE     CATHRYN    CARDENAS  
NIKKI      : GLENN      BELL       HIGGINS    JANINE    
GUTHRIE    : DIONNE     MAYNARD   
ASHLEE     : MAVIS      JOHANNA    AVA       
MASSEY     : BURT       HURLEY     ROCKY      HUBBARD    GRAHAM     ROBERTSON  KEVIN     
TOMMY      : VALERIE   
STEVENS    : ANDREA     CLYDE      WILEY     
COLLEEN    : HOUSTON    DYLAN      ROTH      
VEGA       : ISIAH     
TERRY      : BARLOW     HARRELL    ADKINS     TERENCE    SAVAGE    
NORA       : HOUSTON    EMORY      CARMINE   
JESSE      : GARTH      RICO       ROSALINDA 
ASHLEY     : SANFORD    CANDY     
BERNADETTE : MOLLIE     FULLER    
TIMMY      : RODRIGUEZ  JONI       FRANCIS    CAROLINE  
JANICE     : VERA       LEROY     
MONTOYA    : HOLLIE     SOLIS      DENNIS    
EFREN      : FANNIE     PATRICK   
HERIBERTO  : CASEY     
SHARON     : DONALD     AYALA      VANCE     
JUANITA    : HIGGINS    SWANSON   
AHMED      : ISSAC      PAULETTE   TURNER    
CARR       : SHAWN      KNIGHT    
JARROD     : KOCH       LANCASTER  CLARENCE  
STEWART    : STOUT      SOLOMON   
RAY        : HOMER      ROBERT     ALFONSO   
TRAN       : FRYE       ALTON     
MCCORMICK  : FROST      TAMERA     LORNA     
JUAREZ     : OLIVER     PARSONS   
VALENTINE  : HENSLEY    ROSEANN    INGRAM    
SERRANO    : MARION     JAIME      AMANDA     PETER      ONEIL     
DUKE       : SWEET      TOBY       OTIS      
HECTOR     : ROWE      
LACY       : DELORIS    VICKI      NGUYEN    
AVERY      : ADKINS    
MELBA      : LUCIANO    WENDY      WALLER    
GOLDIE     : MCKAY      PAMELA     FULLER    
ISIAH      : MCMILLAN   STARK      VEGA       SALVATORE  RAUL      
JEREMY     : JIMENEZ    ROSETTA    NOLAN      EDITH      GLOVER    
BARBER     : OSCAR      PITTMAN    BROCK      BIRD       HUFFMAN   
LOWE       : GIBSON     CUMMINGS   PETERSEN  
ALFONZO    : ESTES      WOODWARD   BOYD       WASHINGTON
BUCKLEY    : VERA       FRANCESCA  EVAN       ENID      
CRAIG      : ROXANNE    JEWELL     DAVENPORT  TERRENCE  
ROBBINS    : STUART     LOURDES    CARROLL   
MABEL      : NICOLAS    EDGARDO    STEVEN    
RUSS       : BETTE      NANETTE   
KIDD       : KERRY      MERRITT    TANYA     
FAULKNER   : BELL       LUCIANO    DONALD    
SAMPSON    : MERLIN     GOOD       ROMAN     
ANDREWS    : ODONNELL  
SALINAS    : LEONOR     EDGARDO    PUGH       GIBSON     CHARLES   
DELANEY    : ANTONE     ALVIN      ROSEANN   
AVA        : ROBBY      DEWAYNE    MARCUS     WALTER     ASHLEE    
NEIL       : PAMELA     FEDERICO   MALDONADO  MARTHA     HUBBARD   
RAYMOND    : LATISHA    BLANCHARD  DANIELS    NAVARRO   
BUCHANAN   : QUINTON   
EMILY      : LUCILLE    CHAN      
CONCEPCION : SHERMAN   
KAUFMAN    : WALSH      NORRIS     WILEY      ARNULFO    FREDERICK  LESSIE    
BRADLEY    : GLORIA     ADDIE     
JAYNE      : KATHARINE  GIBBS     
SIMONE     : NEWMAN     FERNANDEZ  DIXIE     
SHEPHERD   : CRYSTAL    AVIS       ERNESTINE 
WILLIAMS   : XAVIER     TIMOTHY    CAMACHO    CALVIN    
MCINTYRE   : HEBERT     SELENA     JARRED     AUBREY     HOWELL     LANG      
WILKINSON  : ROBLES     ANA        DAVID      ANASTASIA 
CAROLINE   : TIMMY     
HOMER      : CHRISTI    BOYD       ANTONIA    RAY        HARPER    
PARRISH    : GUY        SHERMAN   
COX        : CHARMAINE 
STACI      : LAUREN     JULIET    
JACOBS     : ELIZA      HAYS       REFUGIO    HUFFMAN   
ROSARIO    : OLGA       HOLDER     FULLER     LOTT      
MEADOWS    : TRENTON   
BRADSHAW   : CHANDLER   LUCAS      JULIE     
MUELLER    : YANG       HORTON     BRYON      MICAH     
HAZEL      : MCMILLAN  
JARRED     : FLEMING    MCINTYRE  
BRUNO      : STANLEY   
SWANSON    : LITTLE     MARYANNE   MARTINEZ   JUANITA    MILDRED   
CARROLL    : HIRAM      AGNES      JULIA      ROBBINS    CINDY      PARSONS   
VALENCIA   : MARIE      POOLE     
PRESTON    : ROBBIE     OLA        HOLLOWAY  
PEREZ      : ROJAS     
MARCELO    : FROST      WATERS     NATASHA   
MILLS      : ENRIQUE    BERGER     NITA      
GENEVA     : GILMORE    WOODARD   
ERMA       : ABE        ALEXANDER  CONNER    
TINA       : ARIEL      CASE       VICTOR    
TOWNSEND   : BETTE      AUSTIN     GERARDO   
BRENTON    : KELLER     CAROL     
DELORIS    : MERCEDES   LACY       HEWITT    
CANTU      : XAVIER     MOHAMED    RANDALL    BARBRA    
PAYNE      : CHRISTI   
ANTHONY    : KEVEN      ESTEBAN    KELLER    
DELGADO    : PHOEBE     BURTON     REFUGIO    LEMUEL    
MCCRAY     : FOREMAN    MERLE      SETH       ALFONSO   
FREEMAN    : KRISTOPHER EARLENE   
ESTEBAN    : PRINCE     MARIBEL    ANTHONY   
GRACE      : SOTO       ROWE      
ADAMS      : BORIS     
RICKY      : MCDONALD   COLLIER   
LORENA     : BLANCHARD  ROBERTSON 
KARLA      : SIMON      FRANKS     PATEL     
WOODARD    : BENJAMIN   CANDICE    INES       GENEVA     BULLOCK   
JARED      : TOM        GRETA      REESE     
WELLS      : MARGARITA  IRWIN      KRISTEN    COFFEY     MARCIA    
NEWTON     : HANSON     TREY       CATHERINE 
BURRIS     : BRENDAN    DOYLE      MOSS      
MARCY      : ELIJAH     TORRES    
BENITO     : SAM        ALFREDA    WILLIE     PASQUALE  
LARSON     : BRIGHT     PRISCILLA 
VICKI      : COOKE      JASPER     LACY       MAXINE    
DONALD     : MCNEIL     FLOSSIE    SHARON     FAULKNER  
WENDY      : MARK       JARVIS     ESMERALDA  MELBA     
AUBREY     : OSCAR      SAMUEL     FRANCES    MCINTYRE  
DAVID      : WILKINSON  JILLIAN    GILBERTO  
COMPTON    : CANDICE    WILEY     
PUGH       : ELIZA      SALINAS    COLLINS   
MENDOZA    : FREDDIE    GREGORY   
KEITH      : MERCADO    ERIN       MCCONNELL  WEBER      CHARLIE    KENTON    
MERLE      : ROB        DONNY      LETICIA    MICHEAL    KATHLEEN   MCCRAY     SUSANNA   
BREWER     : AMELIA     ROCKY      CORRINE   
VERNON     : ROBIN      WALL       LOTT      
SCOTTIE    : LANGLEY    FLYNN     
ALICIA     : NUNEZ      ELOISE     PRUITT     RORY       RANDALL   
EARLE      : PIERCE     SHANA      HOWARD     TRAVIS    
IAN        : LETITIA    TAMMI      RODRIQUEZ 
JEAN       : MONTY      HARRINGTON
SAUNDERS   : ELMA       LORIE     
DECKER     : JEWELL    
JOSUE      : OSCAR      BENTLEY    AUGUSTINE 
SYKES      : AMIE       CHAN      
MILDRED    : BRADLY     CHANDLER   SWANSON    ROJAS      BEASLEY   
SYBIL      : PERCY      RICHARDS   AUTUMN    
DEANNE     : STACIE     TARA       JOYCE     
BONNER     : MCDONALD   PHILLIP    FERDINAND  JAMEL      BERNADINE  MONROE     MAURICE   
NIELSEN    : SANTIAGO   LINDSAY    ARNULFO    DAREN     
ENGLISH    : HOLT       PATSY      LESSIE    
HOUSE      : ELVIRA     GOODMAN   
LEONARD    : ODELL      SONYA      SALAZAR    KELLER    
WATERS     : FLORINE    MYRA       MARCELO    BULLOCK    RUSSEL    
BENTON     : BRYON      RODGERS    BLAKE     
HARMON     : IRIS       ELMA       AISHA     
DIXON      : ERNIE      DALTON     FINLEY    
ISABELLA   : ERIK       DUFFY     
GARNER     : IRA       
MOODY      : ROSE       FOWLER     JESSICA    MARCIA    
LUISA      : JOHN       CLEMONS   
PUCKETT    : HARRELL    DOROTHEA   HELENA     DUFFY     
WALL       : AYERS      VERNON     GRACIELA   TURNER     ODONNELL  
DEMETRIUS  : DOROTHEA   MOHAMED   
MOHAMED    : LITTLE     LELIA      CANTU      DEMETRIUS  HAWKINS    DUFFY     
GIBSON     : MALLORY    LOWE       SALINAS    GILLESPIE  BOBBI      SELLERS   
SOLOMON    : ROB        SARA       STEWART    NANCY     
GOOD       : MCLAUGHLIN SAMPSON    KYLE       CHUCK     
ELVA       : ERNESTINE  GRAHAM     HOLLOWAY  
NIEVES     : CHUCK      AMADO     
JEWELL     : CONNER     CRAIG      DECKER     FINLEY     DARRYL    
JOSE       : KRISTIE    ANNMARIE   HOLCOMB    CARLO     
DIXIE      : MEREDITH   BERT       FERN       SIMONE     DARIN     
GRAY       : PATEL      GEORGIA   
FULLER     : BERNADETTE GOLDIE     ROSARIO    TEDDY     
ELDON      : DEENA      CECELIA    FLYNN      STEVENSON  JOHNSON   
JESSICA    : JANINE     MOODY      JILLIAN   
GILLESPIE  : MAVIS      GIBSON    
ALEXANDRA  : LEE        DIONNE     LANGLEY   
IRA        : HENDERSON  GARNER    
BIRD       : BUCK       BARBER     LLOYD     
TAMMIE     : BLACKWELL  FLEMING   
RORY       : DIAZ       ROCCO      LANCASTER  ALICIA     LYNN      
MERCER     : FERNANDEZ  CALDWELL   MACDONALD 
STANTON    : HENRIETTA 
GRACIELA   : WALL      
COLLIN     : ARNULFO    YVETTE     WENDI     
BOBBI      : ZAMORA     GIBSON    
MARKS      : MOLINA     PORTER     DUNLAP    
ADKINS     : ISSAC      TERRY      AVERY      CASSIE    
HERMAN     : ETTA       TAMMI      BOYLE      CAROLE    
IRVIN      : LUCILLE   
PATRICK    : ROBINSON   EFREN     
VALENZUELA : HERRERA    CROSBY    
WILKERSON  : PETTY      LUPE       KEVEN     
ANTONIO    : CARISSA    MARGARITO  CAIN      
HERSCHEL   : ISRAEL     EVE       
DWIGHT     : HUGHES     ROSALES   
HURST      : KERRY      DONA      
PAT        : MCKAY      FEDERICO   ROY       
LAURI      : ALBERTO    ROBERTSON  POLLARD   
HENRY      : MAXWELL    ROSALES   
MARSH      : CASTILLO   ELISEO     LES        SHEPARD   
NOEMI      : MCCARTHY   BARTLETT   SEBASTIAN  ERNA       WEBB      
CHRISTIAN  : MICAH      CORY       CHAN      
SHANNON    : DEJESUS    ADAM      
ARNULFO    : SOLIS      KAUFMAN    NIELSEN    COLLIN     SCHROEDER 
SETH       : MCCRAY    
INGRAM     : VALERIE    VALENTINE  KELLY     
ALFRED     : STEPHENS   KERRY      KENNEDY    WINFRED   
CHRISTINE  : GRIMES     GUZMAN     MARISSA   
CINDY      : EUGENIA    CARROLL    LINDSEY   
DAVENPORT  : RIVERA     PAM        CRAIG      ORTIZ      BOWEN     
SANFORD    : PECK       QUINCY     ASHLEY    
COLEMAN    : BALLARD    CROSS      ZAMORA     ANTONIA   
JIM        : VELASQUEZ  COLLIER    ARMSTRONG  GUZMAN     PHELPS    
GENARO     : CRISTINA   CASE       NORTON     HENSLEY    WHITFIELD  WEBB      
CORINNE    : HAWKINS    TRENT     
ELBERT     : CRYSTAL    KLINE      SALAZAR    REYNA     
DAREN      : BRIGHT     VIRGIE     NIELSEN    HOWARD    
YVETTE     : GUY        COLLIN    
MORROW     : LAUREN     DARNELL    HUGH       AYALA     
GUZMAN     : HOBBS      HENDERSON  CHRISTINE  JIM        CORTEZ    
NORMA      : DORIS      LORRAINE  
DAMIAN     : MIKE       JONI      
HUMBERTO   : ESTES      HORN       JOHNSON    PASQUALE  
DICK       : BATTLE     HOWELL    
SONNY      : PETER      DYER       MCCLURE   
MATHIS     : FREDDIE    BASIL     
JULIET     : ROBIN      STACI      JAY       
KRISTEN    : SIDNEY     LAUREL     WELLS      MINNIE     PETERSEN  
SARGENT    : MARIA      EARLENE   
MCCARTY    : CAITLIN    BETTE      FRYE       DALE       RUSSELL    CHERRY    
TANIA      : MCNEIL     MCKENZIE  
JULIE      : JODIE      BRADSHAW  
RONNY      : DENIS      HERMINIA   CORNELIUS  LORAINE   
HENDRICKS  : REYES      BENTLEY   
BOWMAN     : MARCI      BRIDGET   
HARRISON   : DODSON     ELLIS      GUY        BOLTON    
DORA       : ALINE     
ELIJAH     : RITA       MARCY      CURTIS    
ERICKSON   : CHERI      POOLE     
TEDDY      : CASTILLO   BLEVINS    MARY       FULLER     TY        
REFUGIO    : JACOBS     DELGADO   
LOTT       : ROSARIO    VERNON     MAYER     
WATTS      : WEBER      LEVINE     LEROY     
GILES      : JACLYN     LARSEN     HORN       ANNABELLE 
VAN        : GAY       
BULLOCK    : LOIS       CARMINE    WOODARD    WATERS     NAVARRO    ERIK      
GOODWIN    : PEARSON    CROSS     
TORRES     : MERCADO    LORRAINE   MARCY      NADINE     OBRIEN    
WALLER     : WILLARD    MARIA      MELBA      KELLY     
RAPHAEL    : MANN      
ELLIOTT    : KLINE      GONZALES  
MACDONALD  : PRUITT     MERCER    
JAMAR      : EMILE      FOWLER     GERARDO   
LEMUEL     : HANEY      DELGADO    BRAY      
DARIN      : LANGLEY    DIXIE      EDWIN     
ROJAS      : WALDO      PEREZ      MILDRED    CASTRO    
BOYLE      : HERMAN    
KENTON     : CHARLOTTE  LEONARDO   BETHANY    KEITH      KRYSTAL   
MOISES     : CALLAHAN   SANCHEZ   
AUTUMN     : SILAS      CONNER     SYBIL      TURNER     DELBERT   
ROOSEVELT  : FREDERIC   KRISTOPHER WALTER     MCMAHON   
QUINN      : ROSETTA    NOELLE     BOB        GLORIA    
NAVARRO    : TUCKER     RAYMOND    BULLOCK    CHUCK     
FAITH      : MERCEDES   NOE        ROSEMARY   HUFFMAN   
CAIN       : RAMSEY     PERCY      TOBY       PORTER     ANTONIO   
CHANCE     : OCTAVIO    PITTS      CARVER    
BRANDI     : HOLDEN     FORREST    STRONG     LORNA      REILLY    
ROSALINDA  : LATONYA    CLEVELAND  JESSE     
PATSY      : HERBERT    LIZZIE     ENGLISH   
SOSA       : LELIA      ADELINE    SUSIE     
HODGE      : JUSTINE    CARLA     
NANCY      : OLGA       ALFREDA    SOLOMON    BRIDGET    REYNOLDS  
LON        : ROSS       TERRENCE  
TERRELL    : MURIEL    
MERRITT    : LEACH      ELISEO     KIDD      
MATTHEWS   : ROSE       KNIGHT    
CEDRIC     : WOLF       CORNELIUS  FUENTES   
MAXINE     : BRIAN      VICKI     
SUSIE      : PITTMAN    VASQUEZ    LEONEL     SOSA      
HALL       : MAVIS      POPE      
ALYSON     : ONEIL     
CHERRY     : LENORE     SANDOVAL   MCCARTY   
CORTEZ     : MICAH      GUZMAN     HUNT      
EVAN       : WALTON     STEELE     BUCKLEY   
PHILLIP    : LEONOR     MOSES      WILBUR     BONNER    
SUSANNA    : MERLE      BEASLEY    GREENE    
MANNING    : AUSTIN     DANIAL    
CARDENAS   : NICOLE     BERTIE     AMANDA     WALLS     
OTTO       : BRYON      TIMOTHY   
KYLE       : FRIEDA     HENRIETTA  GOOD       JAY       
EARNEST    : MARGARITA  JULIA      SONYA      FRANCISCO 
OLSEN      : BOBBIE     RICHMOND  
WILLIE     : ANITA      LES        BENITO     OLSON     
SCHROEDER  : NANETTE    ARNULFO    PARKS     
TONI       : RAMOS      WARNER     FRIEDA     CLAY       PARSONS   
BILLIE     : BERTIE    
OLSON      : MADELINE   JULIA      WILLIE    
ESTELLA    : SAVANNAH   KANE      
ALBERTO    : JOHN       HANSON     LAURI     
SHARRON    : WASHINGTON COTE      
EDWIN      : LESLIE     EMORY      DARIN     
WHITNEY    : CARSON     MARGARITO 
CURRY      : KRISTOPHER ROMERO     LOURDES   
HUFFMAN    : BARBER     JACOBS     FAITH      ADDIE     
TERENCE    : TERRY      CASEY      GREENE    
SANTANA    : CHARLOTTE  REBEKAH    NUNEZ     
ROMAN      : SAMPSON    MUNOZ      HELGA     
KENDRA     : MCKAY      PARK      
PETERSON   : LIZZIE     MCLEAN     PHELPS     HILL      
ROD        : EVERETT    KRISTINE   CORNELIUS 
BASIL      : CLYDE      KENNEDY    MATHIS    
RICK       : FIELDS     ROY        SIDNEY     COLLINS    NATASHA   
MICHAEL    : CHANG     
BATTLE     : LATONYA    MILLIE     DICK      
COTTON     : MEDINA     AMANDA    
BERNARDO   : HINES      CECELIA    JASPER    
WASHINGTON : MERCEDES   ALFONZO    SHARRON   
JILLIAN    : ROSS       TAMMY      DAVID      JESSICA   
TERRENCE   : OMAR       CALLAHAN   CRAIG      LON       
HERRING    : DEWAYNE    ROWE      
FREDERICK  : TRENTON    ELIZA      BRIGITTE   KAUFMAN   
DYLAN      : HIGGINS    KURT       COLLEEN   
SIMPSON    : MARK       EDMUND    
BRADFORD   : ROY        MAYS      
ERIK       : HOPKINS    BLANCHARD  ISABELLA   BULLOCK   
CALVIN     : STARK      WILLIAMS  
MARIANO    : BARKER     FULTON     FRANKLIN  
BARR       : CANDICE    LYDIA     
ORTIZ      : JOHNS      DAVENPORT  JAMEL     
DON        : PITTMAN    TREVINO    STACY      ROSALES    MCGOWAN    CASEY     
THADDEUS   : BRENDAN    JARVIS     JOHNATHAN  DANIELLE   JAMEL     
SCHWARTZ   : DARNELL    MARCEL     JOHNSON   
AYALA      : WITT       TOM        LORIE      SHARON     MORROW    
HUDSON     : RASMUSSEN 
TRUDY      : MEREDITH   ANIBAL     BRANDY    
ARTHUR     : BRIDGETTE  HENRIETTA  DUNCAN     DEVON     
COFFEY     : DARRELL    WELLS     
MAYER      : LOTT      
NADINE     : CHARITY    TORRES     FRANKIE   
DUNCAN     : BRIDGETTE  ARTHUR     ROBERT    
REGGIE     : ANITA      WILEY     
BLAIR      : FLETCHER  
SHERMAN    : HEIDI      RICHARDS   CONCEPCION PARRISH    HELENA    
LENORA     : ANITA      BERGER     WEAVER     ALVAREZ    TERRI     
CHUCK      : GOOD       NIEVES     NAVARRO    MITCHELL  
GATES      : JULIAN     RUSSEL     GLOVER     MAURICE    DEAN      
SOFIA      : SIMS      
FERDINAND  : MONTY      GUY        MARY       FRANCES    BONNER     BETH      
ISIDRO     : LENARD     STEPHENS   WILL      
KELLER     : BRENTON    ANTHONY    LEONARD   
CANDY      : COOK       KEVEN      ASHLEY    
JAY        : LENARD     KERI       JULIET     KYLE      
TURNER     : AHMED      WALL       AUTUMN    
MUNOZ      : LUNA       ROMAN     
VARGAS     : CHELSEA    FLOYD      MERLIN     RAUL      
WENDI      : LEONARDO   MARIANA    COLLIN     ONEIL     
RANDALL    : MCCALL     CAMERON    CANTU      ALICIA     TANYA     
JOAN       : ANDERSON   WILFORD    EVANGELINE
ERNA       : POTTS      BORIS      LIZZIE     NOEMI     
VANCE      : PAULETTE   BRIGITTE   SHARON    
AMADO      : BROCK      NIEVES     STRONG    
CARVER     : HOLMAN     PIERCE     CHANCE     MAYNARD   
LACEY      : MERCADO    ORR        LINDSAY    CASSIE    
INA        : LOTTIE     BUDDY      MICHEAL   
HARRIET    : ROY        GEORGE    
AISHA      : WOODWARD   HARMON    
ALI        : BERT       JACOB     
FORREST    : JARVIS     BONITA     BRANDI    
ADDIE      : CARLENE    BRADLEY    HUFFMAN   
GALLAGHER  : VASQUEZ    AIDA      
KNIGHT     : RICARDO    CARR       MATTHEWS   SAVANNAH  
KRISTINE   : ROB        ISSAC      JOHNATHAN  ROD        CLINT     
ROBERT     : HEIDI      RAY        DUNCAN     MAYNARD   
CLARENCE   : BENJAMIN   JARROD    
WHITE      : LILA       MCLEOD     NOLAN     
KERRI      : RAMOS     
HOFFMAN    : GRETA      NGUYEN    
TABITHA    : MILLER     CRANE     
DURAN      : JENNINGS   FEDERICO   CATHERINE 
CORNELIUS  : NANETTE    RONNY      CEDRIC     ROD       
HOWELL     : IRIS       MCINTYRE   DICK      
CHARMAINE  : DIONNE     JORDAN     KATHARINE  COX        RUSSO     
ERNIE      : ISABELLE   HARVEY     MOSS       JERALD     DIXON     
MARSHALL   : CAROL     
HOOD       : KARYN      MAYS       NAPOLEON   GARZA      TANNER    
HARRIS     : AVIS       WIGGINS   
FRANKIE    : BLANCHARD  FOREMAN    NADINE    
LAWSON     : TYREE      CLEVELAND 
DEWITT     : PHILLIPS   JOHNATHAN  ADAM       CASTRO    
LEON       : MCNEIL     FEDERICO   PHELPS    
SANCHEZ    : ALLISON    CHARLIE    MOISES     MINNIE    
GONZALES   : ABRAHAM    ELLIOTT   
JEANNE     : BERT      
LIDIA      : GARTH      CURTIS    
CUMMINGS   : LORRAINE   LOWE       ROSALES   
HAWKINS    : VICTORIA   WALTER     MOHAMED    CORINNE    FUENTES   
LE         : VELMA     
ANASTASIA  : RICARDO    WILKINSON  JOHNSTON  
ROYCE      : ANDY       SIMS      
BURKS      : STRICKLAND DUSTY      KEVIN      DANA      
FLYNN      : RONALD     SCOTTIE    ELDON     
DALTON     : TASHA      ANDREA     DIXON     
STRONG     : GABRIELA   BRANDI     AMADO     
CLINT      : TRICIA     KRISTINE  
LORNA      : LEE        MCCORMICK  BRANDI    
ENID       : CAROLYN    SHAWN      BUCKLEY   
JACKSON    : BENJAMIN   WEISS      NEAL       RANDOLPH  
RICHARDSON : SHERYL     LINDA      RODRIQUEZ  GREENE    
BRYANT     : PERRY     
CLEMONS    : KNOX       WIGGINS    LUISA     
CHARLENE   : IGNACIO    CAMACHO   
ROWE       : LUNA       SEARS      BRIGHT     HECTOR     GRACE      HERRING   
REINALDO   : JENNINGS   WILCOX    
JOHNNIE    : EDMUND    
TANYA      : BOLTON     KIDD       RANDALL   
COTE       : JACLYN     SHARRON   
POOLE      : LYDIA      VALENCIA   ERICKSON   HOLLOWAY  
ONEIL      : SERRANO    ALYSON     WENDI     
HELENA     : HARDY      PUCKETT    SHERMAN   
HUBBARD    : MASSEY     NEIL      
MARCEL     : WILL       SCHWARTZ  
BRAY       : RASMUSSEN  LEMUEL    
DAMON      : EDGARDO   
AIDA       : LUCILLE    NEAL       ADELINE    GALLAGHER 
BLAKE      : REEVES     BENTON     DANIEL    
GEORGIA    : BEAN       GRAY      
NELDA      : DEANDRE    CHAVEZ     STACY     
GRAHAM     : HURLEY     MASSEY     ELVA      
HOWARD     : EARLE      DAREN      QUINTON   
STEVENSON  : BLEVINS    SILAS      DAPHNE     AUGUSTINE  ELDON      GALLOWAY  
STACY      : CHAN       DON        NELDA     
CAROL      : SYDNEY     BRENTON    MARSHALL   MITCHELL  
MADDEN     : GLADYS     LEVINE    
ROSALES    : ESTES      GIOVANNI   CAMACHO    DWIGHT     HENRY      DON        CUMMINGS  
ALISSA     : GRETA     
RODERICK   : ART        ROBT      
NOEL       : SIMS       RUSSEL    
MCLEAN     : TAMMY      PETERSON  
CONSUELO   : ROSETTA    MARVIN    
CARLA      : FLETCHER   CAROLYN    HODGE     
KASEY      : DUSTY      GOODMAN   
MORENO     : ANDERSON   NUNEZ      BOOTH     
BARNETT    : MCLEOD     WALSH      CARISSA   
ANDREW     : CONLEY     MCCALL     SUSAN      AURELIA   
SAVANNAH   : ESTELLA    KNIGHT     KRAMER    
DUNLAP     : SILVA      BOYER      MARKS     
MITCHELL   : KIP        CHUCK      CAROL     
HEWITT     : STUART     RONALD     DELORIS   
BARBRA     : DOMINGO    CANTU     
JOSH       : SPENCE     JONI      
MILO       : SUAREZ    
MACK       : ELVIRA     WISE      
ODONNELL   : PAMELA     ANDREWS    WALL      
JOHNSON    : KNOX       HUGHES     ELDON      HUMBERTO   SCHWARTZ  
MINNIE     : KRISTEN    SANCHEZ    ROTH      
CASTRO     : JONI       RITA       BOYER      HOLT       ROJAS      DEWITT    
JAMEL      : GALEN      BONNER     ORTIZ      THADDEUS  
HOLLOWAY   : WITT       SILAS      PRESTON    ELVA       POOLE      MOSLEY    
LANG       : MCINTYRE  
SALVATORE  : SILAS      MOSS       ISIAH      KEVIN     
RANDOLPH   : FEDERICO   MARCI      PRISCILLA  JACKSON   
TRAVIS     : KATHERINE  HARRINGTON FULTON     EARLE      CONSTANCE 
DEVON      : THOMAS     FLOYD      ARTHUR    
FRANCISCO  : REEVES     KURT       EARNEST   
CORRINE    : STACIE     SNOW       BREWER     RENA      
HOGAN      : PAGE       MURIEL    
DANIEL     : LEONEL     BOLTON     BLAKE     
ANGELITA   : EMORY      MOSS       SUSAN     
MARISSA    : LESTER     CHRISTINE  CLAUDIA    HEAD      
OBRIEN     : ERICK      TORRES    
WINFRED    : ERIN       BONITA     ROBIN      ALFRED    
CLAUDIA    : CARLSON    STEFANIE   MARISSA   
GIBBS      : GIOVANNI   LEANN      JAYNE      CAROLE    
FERRELL    : JOANNA     LANCASTER  MCMAHON   
ELINOR     : FRANCESCA  JACOB     
LUCY       : ENRIQUE   
GAY        : INGRID     VAN        HELGA     
MOSLEY     : HOLLOWAY  
FUENTES    : EDMUND     DARRELL    BONITA     LAUREL     CEDRIC     HAWKINS   
JULIAN     : EARLENE    GATES     
PASQUALE   : ERIKA      BENITO     HUMBERTO  
LEROY      : LANCASTER  JANICE     WATTS     
DELBERT    : LANGLEY    LEVINE     AUTUMN    
DANIAL     : ISRAEL     MANNING    ANNABELLE 
PHELPS     : SHANA      JIM        PETERSON   LEON      
MAYNARD    : ESMERALDA  GUTHRIE    CARVER     ROBERT    
JOYNER     : TILLMAN    DEWAYNE    DIANE      OMAR      
CURTIS     : ELIJAH     LIDIA     
CONSTANCE  : WOLF       MCCULLOUGH EVANGELINA TRAVIS    
TANNER     : HOOD      
KRAMER     : ODOM       TATE       SAVANNAH  
MCGOWAN    : CATHRYN    DON       
SELLERS    : ARIEL      GIBSON    
SHELLEY    : RAMSEY     CLAY      
ALFONSO    : NICHOLS    RAY        MCCRAY    
CROSBY     : SWEET      HIRAM      DIANE      ERICKA     VALENZUELA
PARSONS    : DIONNE     MARIANA    JUAREZ     CARROLL    TONI      
HELGA      : JANELLE    BOWERS     ROMAN      GAY       
ALINE      : DONOVAN    MOLLIE     HILARIO    THURMAN    MURIEL     DORA      
GALLOWAY   : CHARLIE    NORTON     FLOYD      STEVENSON 
LINDSEY    : YOUNG      DONNA      MICHEAL    VINCENT    CINDY     
JOSEPHINE  : HULL       TRENT     
BERNADINE  : XAVIER     BONNER    
OWEN       : POTTS      HENRIETTA 
CASEY      : DORIS      BEAN       HERIBERTO  TERENCE    DON        RACHAEL   
TYLER      : MILLICENT 
MARCIA     : DARCY      WELLS      MOODY     
COLLINS    : ANNA       MCCULLOUGH PUGH       RICK      
MONROE     : AMANDA     SERGIO     BONNER    
MARVIN     : INGRID     CONSUELO  
DUFFY      : LESLIE     LEVI       SOTO       ISABELLA   PUCKETT    MOHAMED   
JOHNSTON   : ANTONE     MONTGOMERY MAGGIE     CONNER     ANASTASIA 
KELLY      : OCTAVIO    BRIGHT     INGRAM     WALLER    
RUSSO      : GILBERT    CECELIA    CHARMAINE 
BRIDGET    : CHANEY     BOWMAN     NANCY     
LYNN       : SYDNEY     RORY      
BEASLEY    : MCDONALD   MILDRED    SUSANNA   
ETHEL      : DEANDRE    NOE       
MACIAS     : VILMA      HANNAH     GRIMES     LYDIA      BRUCE      LESSIE    
FINLEY     : RICE       VICTORIA   DIXON      JEWELL    
BARTON     : WARD       ELMA      
RUSSEL     : PAGE       THELMA     WATERS     GATES      NOEL      
PALMER     : HAROLD    
GLOVER     : MONICA     VELMA      JEREMY     GATES     
LAWANDA    : BOWERS     SEBASTIAN 
EVE        : MONICA     RAMIRO     MCFADDEN   HERSCHEL   HARPER    
GILBERTO   : CLARK      CALLAHAN   DAVID     
LLOYD      : ANNA       BIRD      
HEAD       : ANITA      SHERYL     MYERS      MARISSA   
PARKS      : BUCKNER    MARGARITA  SCHROEDER 
MARTIN     : THELMA     ROXANNE   
SAVAGE     : TERRY     
MAURICE    : BONNER     GATES     
STEPHENSON : HILARIO    MORRIS    
NICHOLSON  : CHAN       GERARDO   
BRIGGS     : BEAN      
REYNOLDS   : CLAYTON    COOK       NANCY     
REILLY     : BRANDI    
EVANGELINE : WILFORD    JOAN      
BRYAN      : GILBERT    ENGLAND    GALEN      WHITFIELD  BOB       
NGUYEN     : SNOW       LACY       HOFFMAN   
WEBB       : NOEMI      GENARO    
ROTH       : FOX        AGNES      COLLEEN    MINNIE    
KANE       : VERA       ESTELLA   
ALBERT     : BAKER     
LESSIE     : KAUFMAN    ENGLISH    MACIAS    
ANGIE      : REESE      HAYS      
DEAN       : DEWAYNE    JAIME      GLASS      GATES     
MCCLURE    : LESTER     DARYL      SONNY     
STANLEY    : BUCKNER    SHERYL     AURELIA    HOLDER     FOSTER     BRUNO     
MCBRIDE    : MAVIS      CHANG     
HUNT       : AVIS       HIGGINS    CORTEZ    
BETH       : FERDINAND 
RENA       : CORRINE    LORAINE   
ROBERTSON  : CHRISTI    RICO       MERLIN     MASSEY     LORENA     LAURI     
KEVIN      : MASSEY     BURKS      SALVATORE 
KRYSTAL    : KENTON    
WELDON     : HOLLIE     BRUCE     
ESTRADA    : PEARSON    MERCEDES   DALE       PETER      CLARA     
GREENE     : SUSANNA    TERENCE    RICHARDSON
MCMAHON    : AL         OMAR       ROOSEVELT  FERRELL   
TRENT      : BARRERA    RICHARD    CORINNE    JOSEPHINE 
REGINA     : JOHNS      BUDDY     
POLLARD    : ALLISON    VERN       FREDRIC    LAURI     
QUINTON    : SNOW       BUCHANAN   HOWARD    
CAROLE     : HERMAN     GIBBS      LOGAN     
HOLLAND    : COLON      HENSON     LATISHA   
KERR       : BONITA    
DARRYL     : HENDERSON  JEWELL    
CHARLES    : SALINAS   
LOGAN      : RASMUSSEN  CAROLE    
CASSIE     : SILVA      MARTHA     ADKINS     LACEY     
BOWEN      : DEWAYNE    CUNNINGHAM MARTINEZ   DAVENPORT 
HARPER     : HOMER      EVE       
FRANKLIN   : IRIS       MARA       JONI       FLORENCE   MARIANO   
WONG       : PENNINGTON
MERRILL    : MOSES     
MONA       : WOLF       FULTON    
TONIA      : JOSEPH    
DANA       : BURKS     
ANNABELLE  : LORI       GILES      DANIAL    
TY         : MOSES      TEDDY     
HILL       : SCOTT      PETERSON  
BAUER      : HIGGINS    ALTON      POPE      
TRACY      : WARREN     OLA        CARMINE   
HAYDEN     : LENARD     DENA      
NATASHA    : FRY        MARCELO    RICK      
RAUL       : BURGESS    BURTON     ISIAH      VARGAS    
VAUGHN     : LANCASTER 
LORAINE    : RONNY      RENA      
RACHAEL    : MANN       LEVI       HORN       CASEY     
SHERRI     : JOY        LATISHA    WHITFIELD 
PETERSEN   : GILL       SCOTT      EARL       LOWE       KRISTEN   
